"filename", "language", "C++", "Makefile", "comment", "blank", "total"
"d:\nirav_grad_project\practice\sixth_project\controllers\pioneer_controller\Makefile", "Makefile", 0, 5, 66, 3, 74
"d:\nirav_grad_project\practice\sixth_project\controllers\pioneer_controller\cartesian.cpp", "C++", 109, 0, 1, 16, 126
"d:\nirav_grad_project\practice\sixth_project\controllers\pioneer_controller\cartesian.h", "C++", 12, 0, 10, 6, 28
"d:\nirav_grad_project\practice\sixth_project\controllers\pioneer_controller\defs.h", "C++", 20, 0, 6, 10, 36
"d:\nirav_grad_project\practice\sixth_project\controllers\pioneer_controller\motor.cpp", "C++", 194, 0, 2, 32, 228
"d:\nirav_grad_project\practice\sixth_project\controllers\pioneer_controller\motor.h", "C++", 30, 0, 0, 5, 35
"d:\nirav_grad_project\practice\sixth_project\controllers\pioneer_controller\pioneer_controller.cpp", "C++", 52, 0, 72, 21, 145
"d:\nirav_grad_project\practice\sixth_project\controllers\pioneer_controller\positionController.cpp", "C++", 26, 0, 0, 6, 32
"d:\nirav_grad_project\practice\sixth_project\controllers\pioneer_controller\positionController.h", "C++", 24, 0, 3, 7, 34
"d:\nirav_grad_project\practice\sixth_project\controllers\pioneer_controller\robotController.cpp", "C++", 155, 0, 30, 28, 213
"d:\nirav_grad_project\practice\sixth_project\controllers\pioneer_controller\robotController.h", "C++", 31, 0, 0, 7, 38
"d:\nirav_grad_project\practice\sixth_project\controllers\pioneer_controller\robotUtils.cpp", "C++", 27, 0, 0, 5, 32
"d:\nirav_grad_project\practice\sixth_project\controllers\pioneer_controller\robotsUtils.h", "C++", 12, 0, 0, 5, 17
"d:\nirav_grad_project\practice\sixth_project\controllers\pioneer_controller\sensors.cpp", "C++", 45, 0, 4, 9, 58
"d:\nirav_grad_project\practice\sixth_project\controllers\pioneer_controller\sensors.h", "C++", 27, 0, 1, 5, 33
"Total", "-", 764, 5, 195, 165, 1129